{
    "player_start": {
        "x": 3,
        "y": 3
    },
    "map_size": {
        "width": 17,
        "height": 8
    },
    "map_data": [
        "11111111111111111",
        "10000000000000001",
        "10000022002200001",
        "10000000000000001",
        "10044033033022001",
        "10044000000022001",
        "10000001100000001",
        "11111111111111111"
    ]
}