{
    "player_start": {
        "x": 3,
        "y": 3
    },
    "map_size": {
        "width": 17,
        "height": 8
    },
    "map_data": [
        "#################",
        "##              #",
        "#     #   #     #",
        "#               #",
        "#  ## ## ## ##  #",
        "#  ##       ##  #",
        "#      ##       #",
        "#################"
    ]
}